####################
#..................#
#.################.#
#.#..............#.#
#.#.############.#.#
#.#.#..........#.#.#
#.#.#.########.#.#.#
#.#.#.#......#.#.#.#
#.#.#.#......#.#.#.#
#.#.#.########.#.#.#
#.#.#..........#.#.#
#.#.############.#.#
#.#..............#.#
#.################.#
#..................#
####################
