########################################
#..................##..................#
#.#.##############.##.#.##############.#
#.#..............#.##.#..............#.#
#.#.############.#.##.#.############.#.#
#.#.#..........#.#.##.#.#..........#.#.#
#.#.#.#.######.#.#.##.#.#.#.######.#.#.#
#.#.#.#......#.#.#.##.#.#.#......#.#.#.#
#.#.#.#.####.#.#.#.##.#.#.#.####.#.#.#.#
#.#.#.#.#..#.#.#.#.##.#.#.#.#..#.#.#.#.#
#.#.#.#.#..#.#.#.#.##.#.#.#.#..#.#.#.#.#
#.#.#.#.##.#.#.#.#.##.#.#.#.##.#.#.#.#.#
#.#.#.#......#.#.#.##.#.#.#......#.#.#.#
#.#.#.########.#.#.##.#.#.########.#.#.#
#.#.#..........#.#.##.#.#..........#.#.#
#.#.##########.#.#.##.#.##########.#.#.#
#.#..............#.##.#..............#.#
#.################.##.################.#
#......................................#
##################.##.##################
#......................................#
########################################
