####################
#..................#
#.#.##############.#
#.#..............#.#
#.#.############.#.#
#.#.#..........#.#.#
#.#.#.#.######.#.#.#
#.#.#.#......#.#.#.#
#.#.#.#.####.#.#.#.#
#.#.#.#.#..#.#.#.#.#
#.#.#.#.#..#.#.#.#.#
#.#.#.#.##.#.#.#.#.#
#.#.#.#......#.#.#.#
#.#.#.########.#.#.#
#.#.#..........#.#.#
#.#.##########.#.#.#
#.#..............#.#
#.################.#
#..................#
####################
